Mann (m) (nom) = l’homme  
Frau (f) (nom) = la femme  
Kind (n) (nom) = l’enfant  
Mensch (m) (nom) = l’être humain  
Leute (f/pl) (nom) = les gens  
Familie (f) (nom) = la famille  
Leben (n) (nom) = la vie  
Zeit (f) (nom) = le temps  
Jahr (n) (nom) = l’année  
Tag (m) (nom) = le jour  
Woche (f) (nom) = la semaine  
Monat (m) (nom) = le mois  
Stadt (f) (nom) = la ville  
Land (n) (nom) = le pays  
Name (m) (nom) = le nom  
Sprache (f) (nom) = la langue  
Fachrichtung (f) (nom) = la spécialité (Spezialität)
Wort (n) (nom) = le mot  
Satz (m) (nom) = la phrase  
Buch (n) (nom) = le livre  
Schule (f) (nom) = l’école  
Rechnung (f) (nom) = la facture
Ticket (n) (nom) = le Ticket
Bitte (f) (nom) = la demande
Karte (f) (nom) = la carte
Möglichkeit (f) (nom) = la posibilité
Kalender (m) (nom) = le calendrier
Universität (f) (nom) = l’université  
Lehrer (m) (nom) = le professeur  
Lehrerin (f) (nom) = la professeure  
Schüler (m) (nom) = l’élève (masculin)  
Schülerin (f) (nom) = l’élève (féminin)  
Freund (m) (nom) = l’ami  
Freundin (f) (nom) = l’amie  
Auto (n) (nom) = la voiture  
Datei (f) (nom) = le fichier
Datum (n) (nom) = la donnée / la date
Haus (n) (nom) = la maison  
Zimmer (n) (nom) = la pièce (intérieure)  
Tisch (m) (nom) = la table  
Stuhl (m) (nom) = la chaise  
Tür (f) (nom) = la porte  
Fenster (n) (nom) = la fenêtre  
Geld (n) (nom) = l’argent  
Euro (m) (nom) = l’euro  
Uhr (f) (nom) = la montre / l’heure  
Essen (n) (nom) = la nourriture  
Trinken (n) (nom) = la boisson  
Vater (m) (nom) = le père  
Mutter (f) (nom) = la mère  
Hand (f) (nom) = la main  
Welt (f) (nom) = le monde  
Platz (m) (nom) = la place  
Beispiel (n) (nom) = l’exemple  
Morgen (m) (nom) = le matin  
Wasser (n) (nom) = l’eau  
Katze (f) (nom) = le chat  
Hund (m) (nom) = le chien  
Lächeln (n) (nom) = le sourire  
Glück (n) (nom) = le bonheur  
Liebe (f) (nom) = l’amour  
Fahrrad (n) (nom) = le vélo  
Bahn (f) (nom) = le train  
Alternative (f) (nom) = l'alternative
Auto (n) (nom) = la voiture  
Brief (m) (nom) = la lettre
Zimmer (n) (nom) = la chambre / pièce  
Fenster (n) (nom) = la fenêtre  
Boden (m) (nom) = le sol  
Decke (f) (nom) = le plafond / la couverture  
Wand (f) (nom) = le mur  
Straße (f) (nom) = la rue  
Weg (m) (nom) = le chemin  
Berg (m) (nom) = la montagne  
Baum (m) (nom) = l’arbre  
Blume (f) (nom) = la fleur  
Wald (m) (nom) = la forêt  
Himmel (m) (nom) = le ciel  
Stern (m) (nom) = l’étoile  
Sonne (f) (nom) = le soleil  
Mond (m) (nom) = la lune  
Feuer (n) (nom) = le feu  
Wasser (n) (nom) = l’eau  
Luft (f) (nom) = l’air  
Erde (f) (nom) = la terre  
Sand (m) (nom) = le sable  
Stein (m) (nom) = la pierre  
Gold (n) (nom) = l’or  
Silber (n) (nom) = l’argent (métal)  
Glas (n) (nom) = le verre  
Holz (n) (nom) = le bois  
Papier (n) (nom) = le papier  
Bild (n) (nom) = l’image / le tableau  
Laden (f) (nom) = le magasin (Das Geschäft)
Einkaufszentrum (n) (nom) = le centre commercial
Dienst (m) (nom) = le service
Kneller (m) (nom) = le serveur
Film (m) (nom) = le film  
Musik (f) (nom) = la musique  
Lied (n) (nom) = la chanson  
Ausgang (m) (nom) = la sortie
Eintrag (m) (nom) = l'entrée
Kunst (f) (nom) = l’art  
Frage (f) (nom) = la question  
Antwort (f) (nom) = la réponse  
Idee (f) (nom) = l’idée  
Gedanke (m) (nom) = la pensée  
Gefühl (n) (nom) = le sentiment  
Angst (f) (nom) = la peur  
Hoffnung (f) (nom) = l’espoir  
Freiheit (f) (nom) = la liberté  
Frieden (m) (nom) = la paix  
Krieg (m) (nom) = la guerre  
Arzt (m) (nom) = le médecin  
Ärztin (f) (nom) = la médecin  
Krankenhaus (n) (nom) = l’hôpital  
Patient (m) (nom) = le patient  
Gesundheit (f) (nom) = la santé  
Problem (n) (nom) = le problème  
Lösung (f) (nom) = la solution  
Wissen (n) (nom) = le savoir  
Natur (f) (nom) = la nature  
Tier (n) (nom) = l’animal  
Vogel (m) (nom) = l’oiseau  
Fisch (m) (nom) = le poisson  
Insekt (n) (nom) = l’insecte  
Biene (f) (nom) = l’abeille  
Kuh (f) (nom) = la vache  
Schwein (n) (nom) = le cochon  
Pferd (n) (nom) = le cheval  
Huhn (n) (nom) = la poule  
Ei (n) (nom) = l’œuf  
Brot (n) (nom) = le pain  
Butter (f) (nom) = le beurre  
Käse (m) (nom) = le fromage  
Obst (n) (nom) = les fruits  
Gemüse (n) (nom) = les légumes  
Apfel (m) (nom) = la pomme  
Banane (f) (nom) = la banane  
Orange (f) (nom) = l’orange  
Tomate (f) (nom) = la tomate  
Kartoffel (f) (nom) = la pomme de terre  
Zwiebel (f) (nom) = l’oignon  
Welt (f) (nom) = le monde  
Traum (m) (nom) = le rêve  
Grund (m) (nom) = la raison
Albtraum (m) (nom) = le cauchemar  
Maler (m) (nom) = Le Peintre
Malen (n) (nom) = La Peinture
Künstler (m) (nom) = l'artiste
Gedanke (m) (nom) = la pensée  
Idee (f) (nom) = l’idée  
Erfahrung (f) (nom) = l’expérience  
Zukunft (f) (nom) = le futur  
Vergangenheit (f) (nom) = le passé  
Gegenwart (f) (nom) = le présent  
Plan (m) (nom) = le plan  
Ziel (n) (nom) = le but  
Erfolg (m) (nom) = le succès  
Fehler (m) (nom) = l’erreur  
Unfall (m) (nom) = l’accident  
Karotte (f) (nom) = la carotte
Kartoffel (f) (nom) = la pomme de terre
Tomate (f) (nom) = la tomate
Gurke (f) (nom) = le concombre
Zwiebel (f) (nom) = l’oignon
Knoblauch (m) (nom) = l’ail
Paprika (m) (nom) = le poivron
Blumenkohl (m) (nom) = le chou-fleur
Kirche (f) (nom) = l'église
Pfanne (f) (nom) = la poêle
Küche (f) (nom) = la cuisine
Ofen (m) (nom) = le four
Brokkoli (m) (nom) = le brocoli
Spinat (m) (nom) = les épinards
Erbse (f) (nom) = le pois
Bohne (f) (nom) = le haricot
Kürbis (m) (nom) = la courge / le potiron
Lauch (m) (nom) = le poireau
Sellerie (m) (nom) = le céleri
Rote Bete (f) (nom) = la betterave
Aubergine (f) (nom) = l’aubergine
Zucchini (f) (nom) = la courgette
Artischocke (f) (nom) = l’artichaut
Mais (m) (nom) = le maïs
Pilz (m) (nom) = le champignon
Apfel (m) (nom) = la pomme
Birne (f) (nom) = la poire
Banane (f) (nom) = la banane
Orange (f) (nom) = l’orange
Mandarine (f) (nom) = la mandarine
Zitrone (f) (nom) = le citron
Pfirsich (m) (nom) = la pêche
Aprikose (f) (nom) = l’abricot
Kirsche (f) (nom) = la cerise
Traube (f) (nom) = le raisin
Melone (f) (nom) = le melon
Wassermelone (f) (nom) = la pastèque
Erdbeere (f) (nom) = la fraise
Himbeere (f) (nom) = la framboise
Brombeere (f) (nom) = la mûre
Heidelbeere (f) (nom) = la myrtille
Ananas (m) (nom) = l’ananas
Kiwi (f) (nom) = le kiwi
Pflaume (f) (nom) = la prune
Granatapfel (m) (nom) = la grenade
Feige (f) (nom) = la figue
Dattel (f) (nom) = la datte
Mango (f) (nom) = la mangue
Papaya (f) (nom) = la papaye
Kokosnuss (f) (nom) = la noix de coco
Haar (n) (nom) = le cheveu
Nase (f) (nom) = le nez
Zahn (m) (nom) = la dent
Schrank (m) = l'armoire
Zunge (f) (nom) = la langue
Hals (m) (nom) = le cou
Allianz (f) (nom) = l'alliance
Schulter (f) (nom) = l’épaule
Arm (m) (nom) = le bras
Computer (m) (nom) = l'ordinateur
Toilette (f) (nom) = le Toilette
Badezimmer (n) (nom) = la salle bain
Dusche (f) (nom) = la douche
Brett (n) (nom) = la planche
Ellenbogen (m) (nom) = le coude
Brust (f) (nom) = la poitrine
Rücken (m) (nom) = le dos
Bauch (m) (nom) = le ventre
Bein (n) (nom) = la jambe
Knie (n) (nom) = le genou
Zehe (f) (nom) = l’orteil
Wohlstand (m) = la prospérité
Lunge (f) (nom) = le poumon
Magen (m) (nom) = l’estomac
Haut (f) (nom) = la peau
Vorwurf (m) (nom) = l'accusation
Steuerberater (f) (nom) = conseiller fiscal
Berater (m) (nom) = le conseiller
Steuer (f) (nom) = les taxe
Säule (f) (nom) = le pilier
Vorhängeschloss (f) (nom) = le Cadenat
Bewässerungsanlage (f) (nom) = le système d'irigation
Hängematte (f) (nom) = le hamac
Salbe (f) (nom) = la pomade
Knochen (m) (nom) = l’os
Muskel (m) (nom) = le muscle
Gefahr (f) (nom) = le danger  
Löffel (m) (nom) = la cuillère
Gabel (f) (nom) = la fourchette
Blick (m) (nom) = le regard
Messer (n) (nom) = le couteau
Stift (m) (nom) = le stylo
Heft (n) (nom) = le cahier
Sicherheit (f) (nom) = la sécurité  
Seite (f) (nom) = la page
Wahrheit (f) (nom) = la vérité  
Lüge (f) (nom) = le mensonge  
Erdgeschoss (m) (nom) = le rez-de-chaussée
Etage (f) (m) = l'étage
Geschenk (n) (nom) = le cadeau  
Geburtstag (m) (nom) = l’anniversaire  
Feier (f) (nom) = la fête  
Urlaub (m) (nom) = les vacances  
Förderung (f) (nom) = la promotion
Kauf (m) (nom) = l'achat
Reise (f) (nom) = le voyage  
Ausflug (m) (nom) = l’excursion   
Strand (m) (nom) = la plage  
Meer (n) (nom) = la mer  
Übersetzung (f) (nom) = la Traduction
Computer (m) (nom) = l’ordinateur  
Handy (n) (nom) = le téléphone portable  
Internet (n) (nom) = l’internet  
Herausforderung (f) (nom) = le défi
Mitleid (n) (nom) = la Pitié
Vorurteil (m) (nom) = le préjugé
Adler (m) (nom) = l'aigle
Bildschirm (m) (nom) = l’écran  
Tastatur (f) (nom) = le clavier  
Maus (f) (nom) = la souris  
Programm (n) (nom) = le programme  
Richtung (m) (nom) = la direction (Die Direktion)
E-Mail (f) (nom) = l’e-mail  
Nachricht (f) (nom) = le message  
Korrektur (m) (nom) = la correction
Adresse (f) (nom) = l’adresse  
Passwort (n) (nom) = le mot de passe  
Feuer (n) (nom) = le feu  
Wasser (n) (nom) = l’eau  
Luft (f) (nom) = l’air  
Erde (f) (nom) = la terre  
Teller (m) (nom) = l'assiette
Pfote (f) (nom) = la patte 
Farbe (f) (nom) = la couleur
Zahl (f) (nom) = le nombre 
Umwelt (f) (nom) = l'environement
Bereichen (f) (nom) = le domaine
Flasche (f) (nom) = la bouteille
Fleisch (n) (nom) = la viande
Mannschaften (m) (nom) = l'équipe
Licht (n) (nom) = la lumière  
Schatten (m) (nom) = l’ombre  
Markt (m) (nom) = le marché
Mond (m) (nom) = la lune  
Stern (m) (nom) = l’étoile  
Wolke (f) (nom) = le nuage 
Nächste (m) (nom) = le prochain
Körper (m) (nom) = le corps  
Gesicht (n) (nom) = le visage 
Abend (m) (nom) = le soir 
Mittag (m) (nom) = le midi
Kathedrale (f) = la cathédrale
Sorgen (f) (nom) = le soucis
Wetter (all) (nom) = la météo
Wohnzimmer (n) (nom) = le salon
Sofa (n) (m) = le canapé
Fernsehen (n) (nom) = la Télévision
Regen (m) (nom) = la pluie
Blitze (m) (nom) = la foudre
Ebene (f) (nom) = le niveau
Folge (f) (nom) = une suite
Funktion (n) (nom) = une fonction
Auge (n) (nom) = l’œil  
Ohr (n) (nom) = l’oreille  
Mund (m) (nom) = la bouche  
Verkehr (m) (nom) = le trafic
TransportLinie (f) (nom) = une ligne de transport
Linie (f) (nom) = une ligne
Pfeil (m) (nom) = une flêche
Krankenhaus (m) (nom) = l'hopital
Krankenwagen (m) (nom) = l'ambulance
Runde (m) (nom) = le rond
Rechteck (n) (nom) = le rectangle
Quadrat (n) (nom) = le carré
Dreieck (n) (nom) = le triangle
Hand (f) (nom) = la main  
Wörterbuch (n) (nom) = le dictionnaire
Finger (m) (nom) = le doigt  
Fuß (m) (nom) = le pied  
Herz (n) (nom) = le cœur  
Gesundheit (f) (nom) = la santé  
Krankenhaus (n) (nom) = l’hôpital  
Waren (f) (nom) = la marchandise
Medikament (n) (nom) = le médicament  
Arzt (m) (nom) = le médecin  
Patient (m) (nom) = le patient  
Denkmal (n) (nom) = le monument
Moment (m) (nom) = le moment
Schlüssel (m) (nom) = la clée
Schmerz (m) (nom) = la douleur  
Mal (n) (nom) = la fois
Zentrum (n) (nom) = le centre
Gassen (f) (nom) = la ruelle
Reichtum (m) (nom) = la richesse
Terrassen (f) (nom) = la terrasse
Veranstaltungen (f) (nom) = l'événement
Rot (n) (nom) = le rouge
Blau (n) (nom) = le bleu
Grün (n) (nom) = le vert
Büro (n) (nom) = le bureau
Gelb (n) (nom) = le jaune
Orange (n) (nom) = l’orange
Rosa (n) (nom) = le rose
Lila (n) (nom) = le violet
Violett (n) (nom) = le violet
Braun (n) (nom) = le marron
Schwarz (n) (nom) = le noir
Weiß (n) (nom) = le blanc
Grau (n) (nom) = le gris
Beige (n) (nom) = le beige
Türkis (n) (nom) = le turquoise
sein (verbe) = être  
haben (verbe) = avoir  
werden (verbe) = devenir  
können (verbe) = pouvoir (capacité)  
müssen (verbe) = devoir (obligation)  
wollen (verbe) = vouloir  
sollen (verbe) = devoir (conseil)  
mögen (verbe) = aimer (bien)  
machen (verbe) = faire  
tun (verbe) = faire (familier)  
gehen (verbe) = aller  
kommen (verbe) = venir  
sehen (verbe) = voir  
kopieren (verbe) = copier
kleben (verbe) = coller
erkennen (verbe) = détecter
beraten (verbe) = conseiller
sichrühmen (verbe) = se venter
hören (verbe) = entendre  
sagen (verbe) = dire  
sprechen (verbe) = parler  
fragen (verbe) = demander  
antworten (verbe) = répondre  
wissen (verbe) = savoir  
kennen (verbe) = connaître  
denken (verbe) = penser  
glauben (verbe) = croire  
leben (verbe) = vivre  
lieben (verbe) = aimer (sentiment)  
essen (verbe) = manger  
trinken (verbe) = boire  
schlafen (verbe) = dormir  
arbeiten (verbe) = travailler  
lernen (verbe) = apprendre  
studieren (verbe) = étudier  
fahren (verbe) = conduire / aller  
laufen (verbe) = courir / marcher  
bleiben (verbe) = rester 
beschleunigen (verbe) = accélerer
beginnen (verbe) = commencer  (anfangen)
enden (verbe) = finir  
kaufen (verbe) = acheter
verkaufen (verbe) = vendre
bereit sein (verbe) = être prêt
brauchen (verbe) = avoir besoin de  
fördern (verbe) = promouvoir
suchen (verbe) = chercher  
finden (verbe) = trouver  
geben (verbe) = donner  
nehmen (verbe) = prendre 
speichern (verbe) = enregistrer 
helfen (verbe) = aider  
zeigen (verbe) = montrer  
sitzen (verbe) = être assis  
stehen (verbe) = être debout  
liegen (verbe) = être couché / se trouver  
stellen (verbe) = poser (debout)  
legen (verbe) = poser (couché)  
setzen (verbe) = asseoir  
servieren (verbe) = servir
tragen (verbe) = porter  
ziehen (verbe) = tirer  
weiterverkaufen (verbe) = revendre
einziehen (verbe) = emménager
ausschalten (verbe) = désactiver
sichentfernen (verbe) = s'enlever
fehlen (verbe) = manquer
flüstern (verbe) = chuchoter
ermöglichen (verbe) = permettre (erlauben)
drücken (verbe) = pousser  
werfen (verbe) = jeter  
fallen (verbe) = tomber  
steigen (verbe) = monter 
gründen (verbe) = fonder 
sinken (verbe) = descendre / couler  
bauen (verbe) = construire  
zerstören (verbe) = détruire  
öffnen (verbe) = ouvrir  
korrigieren (verbe) = corriger
schließen (verbe) = fermer  
vergessen (verbe) = oublier  
erinnern (verbe) = se souvenir  
eingeben (verbe) = entrer
ausgehen (verbe) = sortir
erzählen (verbe) = raconter  
erklären (verbe) = expliquer  
sichwundernüber (verbe) = s'étonner de
benutzen (verbe) = utiliser  
bedeuten (verbe) = signifier  
gewinnen (verbe) = gagner  
verlieren (verbe) = perdre 
bieten (verbe) = offrir 
fuktionieren (verbe) = fonctionner
verbessen (verbe) = améliorer
ersetzen (verbe) = remplacer
präsentieren (verbe) = présenter
sichvorstellen (verbe) = se présenter
reisen (verbe) = voyager  
nachdenken (verbe) = réfléchir
denken (verbe) = penser
drücken (verbe) = appuyer
anhören (verbe) = écouter
merken (verbe) = retenir
errichten (verbe) = eriger
platzieren (verbe) = placer
bemerken (verbe) = remarquer
markieren (verbe) = marquer
übernehmen (verbe) = reprendre
besuchen (verbe) = visiter / rendre visite  
anrufen (verbe) = appeler (au téléphone)  
schreiben (verbe) = écrire  
bekommen (verbe) = obtenir  
schneiden (verbe) = couper
abdecken (verbe) = couvrir
lesen (verbe) = lire  
zeichnen (verbe) = dessiner  
fotografieren (verbe) = photographier  
übersetzen (verbe) = traduire
kochen (verbe) = cuisiner  
backen (verbe) = cuire au four  
fortsetzen (verbe) = continuer
waschen (verbe) = laver  
putzen (verbe) = nettoyer  
laufen (verbe) = courir  
springen (verbe) = sauter  
tanzen (verbe) = danser 
schauen (verbe) = regarder
sichfragen (verbe) = se poser la question
singen (verbe) = chanter  
lassen (verbe) = laisser
buchstabieren (verbe) = épeler
wiederholen (verbe) = répéter
verstehen (verbe) = comprendre  
vergessen (verbe) = oublier  
versuchen (verbe) = essayer  
erreichen (verbe) = atteindre  
verlassen (verbe) = quitter  
sichfreuen (verbe) = se réjouir / être content
sichinteressieren (verbe) = s’intéresser  
sicherinnern (verbe) = se souvenir  
sichbeeilen (verbe) = se dépêcher  
sichwaschen (verbe) = se laver  
sichanziehen (verbe) = s’habiller  
sichausziehen (verbe) = se déshabiller  
sichsetzen (verbe) = s’asseoir  
sichfühlen (verbe) = se sentir  
wandern (verbe) = faire de la randonnée  
klettern (verbe) = escalader  
schwimmen (verbe) = nager  
folgen (verbe) = suivre
tauchen (verbe) = plonger  
reisen (verbe) = voyager  
fliegen (verbe) = voler (en avion)  
begleiten (verbe) = accompagner
landen (verbe) = atterrir  
abfahren (verbe) = partir (véhicule)  
ankommen (verbe) = arriver  
prägen (verbe) = rythmer
verlaufen (verbe) = se perdre  
finden (verbe) = trouver  
verlieren (verbe) = perdre  
mieten (verbe) = louer  
bezahlen (verbe) = payer
zahlen (verbe) = compter  
kosten (verbe) = coûter  
besichtigen (verbe) = visiter (lieu)  / admirer
bewundern (verbe) = admirer
genießen (verbe) = profiter / savourer
fühlen (verbe) = ressentir  
sehen (verbe) = voir  
riechen (verbe) = sentir (odorat)  
schmecken (verbe) = goûter  
anfassen (verbe) = toucher  
heilen (verbe) = guérir  
vergessen (verbe) = oublier  
erinnern (verbe) = se souvenir  
entdecken (verbe) = découvrir
zustimmen (verbe) = être d'accord
verlieren (verbe) = perdre  
besitzen (verbe) = posséder  
bauen (verbe) = construire  
zerstören (verbe) = détruire  
lesen (verbe) = lire  
schreiben (verbe) = écrire  
erklären (verbe) = expliquer 
vorbereiten (verbe) = préparer
einladen (verbe) = inviter
reparieren (verbe) = réparer
wählen (verbe) = choisir
warten (verbe) = attendre 
ändern (verbe) = changer
erstellen (verbe) = créer (schaffen)
behalten (verbe) = garder
teilen (verbe) = partager
gut (adjectif) = bon  
historisches (adjectif) = historique
wunderschön (adjectif) = magnifique
unglaublich (adjectif) = incroyable
glaublich (adjectif) = croyable
schlecht (adjectif) = mauvais  
bekannt (adjectif) = connut
unbekannt (adjectif) = inconnut
groß (adjectif) = grand  
klein (adjectif) = petit  
schön (adjectif) = beau  
hübsch (adjectif) = joli
ordentlich (adjectif) = ordonée
hässlich (adjectif) = laid  
alt (adjectif) = vieux  
jung (adjectif) = jeune  
ehrgeizig (adjectif) = ambitieux
verständlich (adjectif) = compréhsensible
neu (adjectif) = neuf  
altmodisch (adjectif) = démodé  
anwesend (adjectif) = présent
abwesend (adjectif) = absent
null (adjectif) = null
freundlich (adjectif) = amical  
nett (adjectif) = gentil  
traurig (adjectif) = triste  
glücklich (adjectif) = heureux  
müde (adjectif) = fatigué  
hungrig (adjectif) = affamé  
fertig (adjectif) = prêt
durstig (adjectif) = assoiffé 
nützlich (adjectif) = utile 
super (adjectif) = superbe
lustig (addjectif) = drole
teuer (adjectif) = cher  
ernst (adjectif) = sérieux (seriös)
billig (adjectif) = bon marché  
wichtig (adjectif) = important  
einfach (adjectif) = simple  
schwierig (adjectif) = difficile  
verschiedenen (adjectif) = différent
einzigartiges (adjectif) = unique
politisches (adjectif) = politique
zusammen (adjectif) = ensemble
wirtschaftliches (adjectif) = économique
belebt (adjectif) = annimée
schnell (adjectif) = rapide  
langsam (adjectif) = lent  
stark (adjectif) = fort  
schwach (adjectif) = faible  
hell (adjectif) = clair  
dunkel (adjectif) = sombre  
warm (adjectif) = chaud  
kalt (adjectif) = froid  
trocken (adjectif) = sec  
nass (adjectif) = mouillé  
möglich (adjectif) = possible
angebot (adjectif) = offert
verfügbar (adjectif) = disponible
sauber (adjectif) = propre  
schmutzig (adjectif) = sale  
hart (adjectif) = dur  
weich (adjectif) = mou  
scharf (adjectif) = tranchant / épicé  
stumpf (adjectif) = émoussé  
lokale (adjectif) = local
laut (adjectif) = bruyant  
leise (adjectif) = silencieux  
nah (adjectif) = proche  
fern (adjectif) = lointain  
leer (adjectif) = vide  
voll (adjectif) = plein  
gemeinsamen (adjectif) = commun
offen (adjectif) = ouvert  
geschlossen (adjectif) = fermé
malerische (adjectif) = pittoresques  
reich (adjectif) = riche  
arm (adjectif) = pauvre  
gesund (adjectif) = en bonne santé  
krank (adjectif) = malade  
original (adjectif) = original
froh (adjectif) = content
atemberaubend (adjectif) = époustouflant
entdeckend (adjectif) = couvrant
klug (adjectif) = intelligent  
dumm (adjectif) = stupide  
ruhig (adjectif) = calme  
glänzend (adjectif) = brillant
farbig (adjectif) = coloré
wenig (adjectif) = peu
laut (adjectif) = bruyant  
interessant (adjectif) = intéressant  
langweilig (adjectif) = ennuyeux  
glatt (adjectif) = lisse  
rau (adjectif) = rugueux  
heiß (adjectif) = très chaud / brûlant  
kühl (adjectif) = frais  
mutig (adjectif) = courageux  
ängstlich (adjectif) = peureux  
beeindruckend (adjectif) = impressionnant  
gefährlich (adjectif) = dangereux  
sicher (adjectif) = sûr / en sécurité  
bequem (adjectif) = confortable  
unbequem (adjectif) = inconfortable 
köstlich (adjectif) = délicieux  
spannend (adjectif) = captivant  
langweilig (adjectif) = ennuyeux  
ruhig (adjectif) = calme  
wild (adjectif) = sauvage  
tief (adjectif) = profond  
flach (adjectif) = plat  q
gesund (adjectif) = en bonne santé  
krank (adjectif) = malade  
hell (adjectif) = clair  
dunkel (adjectif) = sombre  
sauber (adjectif) = propre  
schmutzig (adjectif) = sale  
hart (adjectif) = dur  
weich (adjectif) = mou  
kurz (adjectif) = court  
lang (adjectif) = long  
laut (adjectif) = bruyant  
leise (adjectif) = silencieux  
frei (adjectif) = libre  
besetzt (adjectif) = occupé  
ja (adverbe) = oui  
nein (adverbe) = non  
heute (adverbe) = aujourd’hui  
gestern (adverbe) = hier  
morgen (adverbe) = demain  
jetzt (adverbe) = maintenant  
bald (adverbe) = bientôt  
schon (adverbe) = déjà  
noch (adverbe) = encore  
nie (adverbe) = jamais  
immer (adverbe) = toujours  
manchmal (adverbe) = parfois  
oft (adverbe) = souvent  
selten (adverbe) = rarement  
dort (adverbe) = là-bas 
netz (adverbe) = juste
da (adverbe) = là 
hier (adverbe) = ici  
natürlich (adverbe) = bien sur
ernstlich (adverbe) = sérieusement
überall (adverbe) = partout  
nirgendwo (adverbe) = nulle part  
schnell (adverbe) = rapidement  
langsam (adverbe) = lentement  
gern (adverbe) = volontiers  
vielleicht (adverbe) = peut-être  
draußen (adverbe) = dehors  
drinnen (adverbe) = à l’intérieur  
oben (adverbe) = en haut  
unten (adverbe) = en bas  
vorne (adverbe) = devant  
zu (adverbe) = vers
hinten (adverbe) = derrière  
sofort (adverbe) = immédiatement  
gerade (adverbe) = tout de suite / actuellement  
langsam (adverbe) = lentement  
schnell (adverbe) = rapidement  
leise (adverbe) = doucement (son)  
laut (adverbe) = bruyamment  
täglich (adverbe) = quotidiennement  
oftmals (adverbe) = fréquemment  
zufällig (adverbe) = par hasard  
wahrscheinlich (adverbe) = probablement  
leider (adverbe) = malheureusement  
glücklicherweise (adverbe) = heureusement
sogar (adverbe) = même
also (adverbe) = donc
dann (adverbe) = alors
sonst (adverbe) = sinon
ab (adverbe) = dès
dennoch (adverbe) = pourtant
auch (adverbe) = aussi
dann (adverbe) = ensuite
oder (adverbe) = or
vor (adverbe) = avant
nach (adverbe) = après
jedoch (adverbe) = cependant
während (adverbe) = pendant
Darüber (adverbe) = à ce sujet
hinaus (adverbe) = en outre
andere (adverbe) = autre
wegen (adverbe) = à cause de 
zwischen (adverbe) = entre 
mehrfach (adverbe) = plusieur
niemand (adverbe) = personne fait qqch
genau (adjectif) = exactement 
mehr (adverbe) = plus
weniger (adverbe) = moins
hinterher (adverbe) = à la suite de
neben (adverbe) = à côté    
jede (adverbe) = chaque
irgendetwas (adverbe) = quelque chose 
vollständig (adverbe) = entièrement
wie (adverbe) = comme
Bis (adverbe) = jusqu'à
Oberteil (adverbe) = dessus
Unterseite (adverbe) = dessous
bei (adverbe) = chez
nützlich (adjectif) = utile 
bitte (mot clé) = s’il vous plaît  
danke (mot clé) = merci  
hallo (mot clé) = bonjour  
tschüss (mot clé) = au revoir  
ich (pronom) = je  
du (pronom) = tu  
er (pronom) = il  
sie (pronom) = elle / ils / elles  
es (pronom) = ça / il (neutre)  
wir (pronom) = nous  
ihr (pronom) = vous (pluriel)  
sie (pl.) (pronom) = ils / elles  
Sie (pol.) (pronom) = vous (politesse)  
und (conjonc.) = et  
oder (conjonc.) = ou  
aber (conjonc.) = mais  
weil (conjonc.) = parce que  
dass (conjonc.) = que  
wenn (conjonc.) = quand / si  
wo (adv/int.) = où  
wann (adv/int.) = quand  
warum (adv/int.) = pourquoi  
wie (adv/int.) = comment  
was (adv/int.) = quoi  
wer (adv/int.) = qui
wohin (adv/int.) = vers ou
welchezeit (adv/int.) = quelle heure
wieviel (adv/int.) = combien